0001100001
0000000001
0100000001
0100000001
0100000001
0100000000
0000010000
0000010000
0000010000
0011100000